"a" = (/turf/space,/area/space)
"b" = (/obj/machinery/door/airlock/multi_tile/metal{dir = 2},/obj/machinery/door/blast/regular,/turf/space,/area/space)
"c" = (/turf/simulated/floor/wood,/area/space)
"f" = (/obj/machinery/door/blast/regular/open,/obj/machinery/door/airlock/maintenance_command,/turf/simulated/floor/tiled/dark/techfloor_grid,/area/space)
"g" = (/obj/item/ammo_casing/magnum/hv,/turf/simulated/floor/tiled/dark/techfloor_grid,/area/space)
"h" = (/turf/simulated/floor/tiled/dark/techfloor_grid,/area/space)
"i" = (/obj/machinery/atmospherics/unary/vent_pump/high_volume{dir = 4; frequency = 1331; id_tag = "second_sec_1_airlock_pump"; name = "Second Section Airlock Pump - 1"},/turf/simulated/floor/tiled/dark/techfloor_grid,/area/space)
"j" = (/obj/landmark/corpse,/obj/effect/decal/cleanable/blood,/obj/item/gun/projectile/mk58{ammo_magazine = /obj/item/ammo_magazine/pistol; icon_state = "mk58_full"; pixel_x = -8; pixel_y = -8},/turf/simulated/floor/tiled/dark/techfloor_grid,/area/space)
"k" = (/obj/machinery/door/airlock/maintenance_command,/turf/space,/area/space)
"l" = (/turf/simulated/wall/r_wall,/area/space)
"m" = (/turf/simulated/floor/tiled/cafe,/area/space)
"o" = (/obj/machinery/door/airlock/multi_tile/metal,/turf/simulated/floor/tiled/dark/techfloor_grid,/area/space)
"p" = (/obj/effect/window_lwall_spawn/reinforced,/turf/space,/area/space)
"q" = (/obj/machinery/atmospherics/pipe/simple/hidden{dir = 4},/turf/simulated/floor/tiled/dark/techfloor_grid,/area/space)
"r" = (/obj/machinery/atmospherics/pipe/simple/hidden,/turf/simulated/floor/tiled/dark/techfloor_grid,/area/space)
"u" = (/obj/structure/table/reinforced,/obj/item/storage/firstaid/regular,/turf/simulated/floor/tiled/dark,/area/space)
"w" = (/obj/structure/bed/chair/comfy,/turf/simulated/floor/wood,/area/space)
"x" = (/obj/effect/window_lwall_spawn/reinforced/polarized,/turf/space,/area/space)
"z" = (/turf/simulated/floor/tiled/dark,/area/space)
"C" = (/obj/machinery/atmospherics/pipe/simple/hidden{dir = 9},/turf/simulated/floor/tiled/dark/techfloor_grid,/area/space)
"F" = (/turf/simulated/floor/carpet/purcarpet,/area/space)
"G" = (/obj/machinery/door/airlock/multi_tile/metal{dir = 1},/turf/simulated/floor/tiled/dark/techfloor_grid,/area/space)
"H" = (/obj/machinery/door/airlock,/obj/machinery/door/blast/regular{dir = 8},/turf/simulated/floor/tiled/dark,/area/space)
"L" = (/obj/machinery/door/airlock/multi_tile/metal,/obj/machinery/atmospherics/pipe/simple/hidden,/turf/simulated/floor/tiled/dark/techfloor_grid,/area/space)
"N" = (/obj/structure/cyberplant,/turf/simulated/floor/wood,/area/space)
"O" = (/obj/machinery/computer/navigation,/turf/simulated/floor/tiled/dark,/area/space)
"P" = (/obj/structure/bed/chair/comfy{dir = 8},/turf/simulated/floor/wood,/area/space)
"R" = (/obj/structure/bed/chair/shuttle{dir = 1},/turf/simulated/floor/tiled/dark,/area/space)
"S" = (/obj/machinery/door/airlock/glass,/turf/simulated/floor/tiled/dark,/area/space)
"V" = (/obj/item/modular_computer/console/preset/command,/turf/simulated/floor/tiled/dark,/area/space)
"W" = (/obj/machinery/door/airlock/maintenance_command,/turf/simulated/floor/tiled/dark,/area/space)
"X" = (/obj/machinery/door/blast/regular,/turf/space,/area/space)
"Z" = (/obj/machinery/atmospherics/portables_connector,/obj/machinery/portable_atmospherics/canister/air/airlock,/turf/simulated/floor/tiled/dark/techfloor_grid,/area/space)

(1,1,1) = {"
aaaaaaaaaaaaaaaaaaaaaaaaaaaaaaaaaaaaaaaaaaaaaaaaaaaaaaaaaaaa
aaaaaaaaaaaaaaaaaaaaaaaaaaaaaaaaaaaaaaaaaaaaaaaaaaaaaaaaaaaa
aaaaaaaaaaaaaaaaaaaaaaaaaaaaaaaaaaaaaaaaaaaaaaaaaaaaaaaaaaaa
aaaaaaaaaaaaaaaaaaaaaaaaaaaaaaaaaaaaaaaaaaaaaaaaaaaaaaaaaaaa
aaaaaaaaaaaaaaaaaaaaaaaaaaaaaaaaaaaaaaaaaaaaaaaaaaaaaaaaaaaa
aaaaaaaaaaaaaaaaaaaaaaaaaaaaaaaaaaaaaaaaaaaaaaaaaaaaaaaaaaaa
aaaaaaaaaaaaaaaaaaaaaaaaaaaaaaaaaaaaaaaaaaaaaaaaaaaaaaaaaaaa
aaaaaaaaaaaaaaaaaaaaaaaaaaaaaaaaaaaaaaaaaaaaaaaaaaaaaaaaaaaa
aaaaaaaaaaaaaaaaaaaaaaaaaaaaaaaaaaaaaaaaaaaaaaaaaaaaaaaaaaaa
aaaaaaaaaaaaaaaaaaaaaaaaaaaaaaaaaaaaaaaaaaaaaaaaaaaaaaaaaaaa
aaaaaaaaaaaaaaaaaaaaaaaaaaaaaaaaaaaaaaaaaaaaaaaaaaaaaaaaaaaa
aaaaaaaaaaaaaaaaaaaaaaaaaaaaaaaaaaaaaaaaaaaaaaaaaaaaaaaaaaaa
aaaaaaaaaaaaaaaaaaaaaaaaaaaaaaaaaaaaaaaaaaaaaaaaaaaaaaaaaaaa
aaaaaaaaaaaaaaaaaaaaaaaaaaaaaaaaaaaaaaaaaaaaaaaaaaaaaaaaaaaa
aaaaaaaaaaaaaaaaaaaaaaaaaaaaaaaaaaaaaaaaaaaaaaaaaaaaaaaaaaaa
aaaaaaaaaaaaaaaaaaaaaaaaaaaaaaaaaaaaaaaaaaaaaaaaaaaaaaaaaaaa
aaaaaaaaaaaaaaaaaaalppppppplaaaaaaaaaaaaaaaaaaaaaaaaaaaaaaaa
aaaaaaaaaaaaaaaaaalzzzOzVzzzlaaaaaaaaaaaaaaaaaaaaaaaaaaaaaaa
aaaaaaaaaaaaaaaaalzzzzRzRzzzzlaaaaaaaaaaaaaaaaaaaaaaaaaaaaaa
aaaaaaaaaaaaaaaaalzzzzzzzzzzzlaaaaaaaaaaaaaaaaaaaaaaaaaaaaaa
aaaaaaaaaaaaaaaalzzzzzzzzzzzzzlaaaaaaaaaaaaaaaaaaaaaaaaaaaaa
aaaaaaaaaaaaaaaalzullllHllllzzlaaaaaaaaaaaaaaaaaaaaaaaaaaaaa
aaaaaaaaaaaaaaaalflzzzlzzzzzlWlaaaaaaaaaaaaaaaaaaaaaaaaaaaaa
aaaaaaaaaaaaaaaalhlzzzlzzzzzlzlxxaaaaaaaaaaaaaaaaaaaaaaaaaaa
aaaaaaaaaaaaaaalZjlzzzlzzzzzSzwwNxaaaaaaaaaaaaaaaaaaaaaaaaaa
aaaaaaaaaaaaaaalrhlzzzlzzzzzlzFFPxaaaaaaaaaaaaaaaaaaaaaaaaaa
aaaaaaaaaaaaaaalrglzzzlzzzzzlzFFPxaaaaaaaaaaaaaaaaaaaaaaaaaa
aaaaaaaaaaaallllLhlzzzlzzzzzlzFFcxaaaaaaaaaaaaaaaaaaaaaaaaaa
aaaaaaaaaaaahiqqChXzzzlzzzzzzzFFcxaaaaaaaaaaaaaaaaaaaaaaaaaa
aaaaaaaaaaaaGhhGhhbzzzlzzzzzzzzzzlaaaaaaaaaaaaaaaaaaaaaaaaaa
aaaaaaaaaaaallllohllkllllllllmmmmlaaaaaaaaaaaaaaaaaaaaaaaaaa
aaaaaaaaaaaaaaalhhlaaaaaaaaalmmmmxaaaaaaaaaaaaaaaaaaaaaaaaaa
aaaaaaaaaaaaaaalhhlaaaaaaaaalmmmmxaaaaaaaaaaaaaaaaaaaaaaaaaa
aaaaaaaaaaaaaaalhhlaaaaaaaaallxxxlaaaaaaaaaaaaaaaaaaaaaaaaaa
aaaaaaaaaaaaaaaaaaaaaaaaaaaaaaaaaaaaaaaaaaaaaaaaaaaaaaaaaaaa
aaaaaaaaaaaaaaaaaaaaaaaaaaaaaaaaaaaaaaaaaaaaaaaaaaaaaaaaaaaa
aaaaaaaaaaaaaaaaaaaaaaaaaaaaaaaaaaaaaaaaaaaaaaaaaaaaaaaaaaaa
aaaaaaaaaaaaaaaaaaaaaaaaaaaaaaaaaaaaaaaaaaaaaaaaaaaaaaaaaaaa
aaaaaaaaaaaaaaaaaaaaaaaaaaaaaaaaaaaaaaaaaaaaaaaaaaaaaaaaaaaa
aaaaaaaaaaaaaaaaaaaaaaaaaaaaaaaaaaaaaaaaaaaaaaaaaaaaaaaaaaaa
aaaaaaaaaaaaaaaaaaaaaaaaaaaaaaaaaaaaaaaaaaaaaaaaaaaaaaaaaaaa
aaaaaaaaaaaaaaaaaaaaaaaaaaaaaaaaaaaaaaaaaaaaaaaaaaaaaaaaaaaa
aaaaaaaaaaaaaaaaaaaaaaaaaaaaaaaaaaaaaaaaaaaaaaaaaaaaaaaaaaaa
aaaaaaaaaaaaaaaaaaaaaaaaaaaaaaaaaaaaaaaaaaaaaaaaaaaaaaaaaaaa
aaaaaaaaaaaaaaaaaaaaaaaaaaaaaaaaaaaaaaaaaaaaaaaaaaaaaaaaaaaa
aaaaaaaaaaaaaaaaaaaaaaaaaaaaaaaaaaaaaaaaaaaaaaaaaaaaaaaaaaaa
aaaaaaaaaaaaaaaaaaaaaaaaaaaaaaaaaaaaaaaaaaaaaaaaaaaaaaaaaaaa
aaaaaaaaaaaaaaaaaaaaaaaaaaaaaaaaaaaaaaaaaaaaaaaaaaaaaaaaaaaa
aaaaaaaaaaaaaaaaaaaaaaaaaaaaaaaaaaaaaaaaaaaaaaaaaaaaaaaaaaaa
aaaaaaaaaaaaaaaaaaaaaaaaaaaaaaaaaaaaaaaaaaaaaaaaaaaaaaaaaaaa
aaaaaaaaaaaaaaaaaaaaaaaaaaaaaaaaaaaaaaaaaaaaaaaaaaaaaaaaaaaa
aaaaaaaaaaaaaaaaaaaaaaaaaaaaaaaaaaaaaaaaaaaaaaaaaaaaaaaaaaaa
aaaaaaaaaaaaaaaaaaaaaaaaaaaaaaaaaaaaaaaaaaaaaaaaaaaaaaaaaaaa
aaaaaaaaaaaaaaaaaaaaaaaaaaaaaaaaaaaaaaaaaaaaaaaaaaaaaaaaaaaa
aaaaaaaaaaaaaaaaaaaaaaaaaaaaaaaaaaaaaaaaaaaaaaaaaaaaaaaaaaaa
aaaaaaaaaaaaaaaaaaaaaaaaaaaaaaaaaaaaaaaaaaaaaaaaaaaaaaaaaaaa
aaaaaaaaaaaaaaaaaaaaaaaaaaaaaaaaaaaaaaaaaaaaaaaaaaaaaaaaaaaa
aaaaaaaaaaaaaaaaaaaaaaaaaaaaaaaaaaaaaaaaaaaaaaaaaaaaaaaaaaaa
aaaaaaaaaaaaaaaaaaaaaaaaaaaaaaaaaaaaaaaaaaaaaaaaaaaaaaaaaaaa
aaaaaaaaaaaaaaaaaaaaaaaaaaaaaaaaaaaaaaaaaaaaaaaaaaaaaaaaaaaa
"}
