"b" = (/obj/structure/table/rack,/obj/item/tool/hammer/sledgehammer/ironhammer,/obj/item/tool/hammer/sledgehammer/ironhammer,/obj/item/tool/hammer/sledgehammer/ironhammer,/obj/item/tool/hammer/sledgehammer/ironhammer,/turf/simulated/floor/tiled/dark/gray_platform,/area/space)
"c" = (/obj/structure/table/rack,/obj/item/gun/projectile/lamia,/obj/item/gun/projectile/lamia,/obj/item/gun/projectile/lamia,/obj/item/gun/projectile/lamia,/turf/simulated/floor/tiled/dark/gray_platform,/area/space)
"d" = (/obj/structure/multiz/stairs/active{dir = 4},/turf/space,/area/space)
"e" = (/turf/simulated/mineral,/area/space)
"f" = (/obj/structure/sign/department/armory{pixel_x = 32},/turf/simulated/floor/tiled/dark/bluecorner,/area/space)
"g" = (/turf/simulated/floor/tiled/dark/bluecorner,/area/space)
"h" = (/obj/structure/table/rack,/obj/item/clothing/suit/armor/vest/full/ironhammer,/obj/item/clothing/suit/armor/vest/full/ironhammer,/obj/item/clothing/suit/armor/vest/full/ironhammer,/obj/item/clothing/suit/armor/vest/full/ironhammer,/turf/simulated/floor/tiled/dark/gray_platform,/area/space)
"i" = (/turf/space,/area/space)
"j" = (/obj/structure/table/rack,/obj/item/gun/projectile/paco,/obj/item/gun/projectile/paco,/obj/item/gun/projectile/paco,/obj/item/gun/projectile/paco,/turf/simulated/floor/tiled/dark/gray_platform,/area/space)
"k" = (/turf/simulated/floor/tiled/dark/gray_perforated,/area/space)
"n" = (/turf/simulated/wall/r_wall,/area/space)
"p" = (/obj/structure/table/rack,/obj/item/gun/projectile/automatic/molly,/obj/item/gun/projectile/automatic/molly,/obj/item/gun/projectile/automatic/molly,/obj/item/gun/projectile/automatic/molly,/turf/simulated/floor/tiled/dark/gray_platform,/area/space)
"q" = (/obj/structure/table/rack,/obj/item/gun/projectile/automatic/wintermute,/obj/item/gun/projectile/automatic/wintermute,/obj/item/gun/projectile/automatic/wintermute,/obj/item/gun/projectile/automatic/wintermute,/turf/simulated/floor/tiled/dark/gray_platform,/area/space)
"r" = (/obj/structure/table/rack,/obj/item/clothing/head/armor/bulletproof/ironhammer_full,/obj/item/clothing/head/armor/bulletproof/ironhammer_full,/obj/item/clothing/head/armor/bulletproof/ironhammer_full,/obj/item/clothing/head/armor/bulletproof/ironhammer_full,/turf/simulated/floor/tiled/dark/gray_platform,/area/space)
"s" = (/obj/structure/multiz/stairs/enter{dir = 8},/turf/simulated/floor/dirt,/area/space)
"t" = (/obj/structure/table/rack,/obj/item/clothing/head/armor/riot_hud,/obj/item/clothing/head/armor/riot_hud,/obj/item/clothing/head/armor/riot_hud,/obj/item/clothing/head/armor/riot_hud,/turf/simulated/floor/tiled/dark/gray_platform,/area/space)
"u" = (/turf/simulated/floor/tiled/steel/bluecorner,/area/space)
"v" = (/obj/structure/table/rack,/obj/item/gun/projectile/automatic/straylight,/obj/item/gun/projectile/automatic/straylight,/obj/item/gun/projectile/automatic/straylight,/obj/item/gun/projectile/automatic/straylight,/turf/simulated/floor/tiled/dark/gray_platform,/area/space)
"w" = (/turf/simulated/floor/tiled/dark,/area/space)
"y" = (/obj/structure/table/rack,/obj/item/clothing/suit/space/void/security/equipped,/obj/item/clothing/suit/space/void/security/equipped,/obj/item/clothing/suit/space/void/security/equipped,/obj/item/clothing/suit/space/void/security/equipped,/turf/simulated/floor/tiled/dark/gray_platform,/area/space)
"z" = (/turf/simulated/floor/tiled/dark/danger,/area/space)
"A" = (/obj/structure/table/rack,/obj/item/clothing/head/armor/helmet/ironhammer,/obj/item/clothing/head/armor/helmet/ironhammer,/obj/item/clothing/head/armor/helmet/ironhammer,/obj/item/clothing/head/armor/helmet/ironhammer,/turf/simulated/floor/tiled/dark/gray_platform,/area/space)
"B" = (/obj/structure/multiz/stairs/active{dir = 8},/turf/space,/area/space)
"C" = (/obj/structure/table/rack,/obj/item/gun/projectile/shotgun/bull,/obj/item/gun/projectile/shotgun/bull,/obj/item/gun/projectile/shotgun/bull,/obj/item/gun/projectile/shotgun/bull,/turf/simulated/floor/tiled/dark/gray_platform,/area/space)
"D" = (/obj/structure/multiz/stairs/active{dir = 8},/turf/simulated/floor/dirt,/area/space)
"E" = (/obj/structure/table/rack,/obj/item/clothing/suit/storage/vest/ironhammer,/obj/item/clothing/suit/storage/vest/ironhammer,/obj/item/clothing/suit/storage/vest/ironhammer,/obj/item/clothing/suit/storage/vest/ironhammer,/turf/simulated/floor/tiled/dark/gray_platform,/area/space)
"F" = (/obj/structure/table/rack,/obj/item/clothing/suit/armor/heavy/ironhammer,/obj/item/clothing/suit/armor/heavy/ironhammer,/obj/item/clothing/suit/armor/heavy/ironhammer,/obj/item/clothing/suit/armor/heavy/ironhammer,/turf/simulated/floor/tiled/dark/gray_platform,/area/space)
"G" = (/obj/structure/table/rack,/obj/item/gun/projectile/shotgun/pump/gladstone,/obj/item/gun/projectile/shotgun/pump/gladstone,/obj/item/gun/projectile/shotgun/pump/gladstone,/obj/item/gun/projectile/shotgun/pump/gladstone,/turf/simulated/floor/tiled/dark/gray_platform,/area/space)
"H" = (/turf/simulated/floor/tiled/dark/cargo,/area/space)
"I" = (/obj/structure/sign/department/armory{pixel_x = -32},/turf/simulated/floor/tiled/dark/bluecorner,/area/space)
"J" = (/obj/machinery/door/airlock/multi_tile/glass,/turf/space,/area/space)
"K" = (/obj/effect/window_lwall_spawn/reinforced,/turf/simulated/floor/plating,/area/space)
"L" = (/turf/simulated/floor/asteroid,/area/space)
"M" = (/obj/structure/multiz/stairs/enter{dir = 8},/turf/space,/area/space)
"N" = (/obj/structure/table/rack,/obj/item/gun/projectile/shotgun/pump/grenade/lenar,/obj/item/gun/projectile/shotgun/pump/grenade/lenar,/obj/item/gun/projectile/shotgun/pump/grenade/lenar,/obj/item/gun/projectile/shotgun/pump/grenade/lenar,/turf/simulated/floor/tiled/dark/gray_platform,/area/space)
"O" = (/obj/structure/table/rack,/obj/item/gun/energy/plasma/cassad,/obj/item/gun/energy/plasma/cassad,/obj/item/gun/energy/plasma/cassad,/obj/item/gun/energy/plasma/cassad,/turf/simulated/floor/tiled/dark/gray_platform,/area/space)
"P" = (/obj/structure/multiz/stairs/active{dir = 4},/turf/simulated/floor/dirt,/area/space)
"Q" = (/obj/machinery/door/airlock/security{name = "Armory"; req_access = list(1)},/turf/simulated/floor/tiled/dark/cargo,/area/space)
"R" = (/obj/structure/multiz/stairs/enter{dir = 4},/turf/simulated/floor/dirt,/area/space)
"S" = (/obj/structure/table/rack,/obj/item/gun/projectile/automatic/lmg/tk,/obj/item/gun/projectile/automatic/lmg/tk,/obj/item/gun/projectile/automatic/lmg/tk,/obj/item/gun/projectile/automatic/lmg/tk,/turf/simulated/floor/tiled/dark/gray_platform,/area/space)
"T" = (/obj/structure/table/rack,/obj/item/clothing/mask/gas/ihs,/obj/item/clothing/mask/gas/ihs,/obj/item/clothing/mask/gas/ihs,/obj/item/clothing/mask/gas/ihs,/turf/simulated/floor/tiled/dark/gray_platform,/area/space)
"U" = (/obj/machinery/autolathe/loaded,/turf/simulated/floor/tiled/dark/gray_perforated,/area/space)
"V" = (/obj/structure/multiz/stairs/enter{dir = 4},/turf/space,/area/space)
"W" = (/obj/structure/table/rack,/obj/item/clothing/mask/balaclava/tactical,/obj/item/clothing/mask/balaclava/tactical,/obj/item/clothing/mask/balaclava/tactical,/obj/item/clothing/mask/balaclava/tactical,/turf/simulated/floor/tiled/dark/gray_platform,/area/space)
"X" = (/obj/structure/table/rack,/obj/item/gun/projectile/automatic/sol,/obj/item/gun/projectile/automatic/sol,/obj/item/gun/projectile/automatic/sol,/obj/item/gun/projectile/automatic/sol,/turf/simulated/floor/tiled/dark/gray_platform,/area/space)
"Y" = (/obj/structure/table/rack,/obj/item/clothing/suit/armor/bulletproof/ironhammer,/obj/item/clothing/suit/armor/bulletproof/ironhammer,/obj/item/clothing/suit/armor/bulletproof/ironhammer,/obj/item/clothing/suit/armor/bulletproof/ironhammer,/turf/simulated/floor/tiled/dark/gray_platform,/area/space)
"Z" = (/obj/structure/table/rack,/turf/simulated/floor/tiled/dark/gray_platform,/area/space)

(1,1,1) = {"
eeeeeeeeeeeeeeeeeeeeeeeeeeeeeeeeeeeeeeeeeeeeeeeeeeeeeeeeeeee
eeeeeeeeeeeeeeeeeeeeeeeeeeeeeeeeeeeeeeeeeeeeeeeeeeeeeeeeeeee
eeeeeeeeeeeeeeeeeeeeeeeeeeeeeeeeeeeeeeeeeeeeeeeeeeeeeeeeeeee
eeeeeeeeeeeeeeeeeeeeeeeeeeeeeeeeeeeeeeeeeeeeeeeeeeeeeeeeeeee
eeeeeeeeeeeeeeeeeeeeeeeeeeeeeeeeeeeeeeeeeeeeeeeeeeeeeeeeeeee
eeeeeeeeeeeeeeeeeeeeeeeeeeeeeeeeeeeeeeeeeeeeeeeeeeeeeeeeeeee
eeeeeeeeeeeeeeeeeeeeeeeeeeeeeeeeeeeeeeeeeeeeeeeeeeeeeeeeeeee
eeeeeeeeeeeeeeeeeeeeeeeeeeeeeeeeeeeeeeeeeeeeeeeeeeeeeeeeeeee
eeeeeeeeeeeeeeeeeeeeeeeeeeeeeeeeeeeeeeeeeeeeeeeeeeeeeeeeeeee
eeeeeeeeeeeeeeeeeeeeeeeeeeeeeeeeeeeeeeeeeeeeeeeeeeeeeeeeeeee
eeeeeeeeeeeeeeeeeeeeeeeeeeeeeeeeeeeeeeeeeeeeeeeeeeeeeeeeeeee
eeeeeeeeeeeeeeeeeeeeeeeeeeeeeeeeeeeeeeeeeeeeeeeeeeeeeeeeeeee
eeeeeeeeeeeeeeeeeeeeeeeeeeeeeeeeeeeeeeeeeeeeeeeeeeeeeeeeeeee
eeeeeeeeeeeeeeeeeeeeeeeeeeeeeeeeeeeeeeeeeeeeeeeeeeeeeeeeeeee
eeeeeeeeeeeeeeeeeeeeeeeeeeeeeeeeeeeeeeeeeeeeeeeeeeeeeeeeeeee
eeeeeeeeeeeeeeeeeeeeeeeeeeeeeeeeeeeeeeeeeeeeeeeeeeeeeeeeeeee
eeeeeeeeeeeeeeeeeeeeeeeeeeeeeeeeeeeeeeeeeeeeeeeeeeeeeeeeeeee
eeeeeeeeeeeeeeeeeeeeeeeeeeeeeeeeeeeeeeeeeeeeeeeeeeeeeeeeeeee
eeeeeeeeeeeeeeeeeeeeeeeeeeeeeeeeeeeeeeeeeeeeeeeeeeeeeeeeeeee
eeeeeeeeeeeeeeeeeeeeeeeeeeeeeeeeeeeeeeeeeeeeeeeeeeeeeeeeeeee
eeeeeeeeeeeeeeeeeeeeeeeeeeeeeeeeeeeeeeeeeeeeeeeeeeeeeeeeeeee
eeeeeeeeeeeeeeeeeeeeeeeeeeeeeeeeeeeeeeeeeeeeeeeeeeeeeeeeeeee
eeeeeeeeeeeeeeeeeeeeeeeeeeeeeeeeeeeeeeeeeeeeeeeeeeeeeeeeeeee
eeeeeeeeeeeeeeeeeeeeeeeeeeeeeeeeeeeeeeeeeeeeeeeeeeeeeeeeeeee
eeeeeeeeeeeeeeeeeeeeeeeeeeeeeeeeeeeeeeeeeeeeeeeeeeeeeeeeeeee
eeeeeeeeeeeeeeeeeeeeeeeeeeeeeeeeeeeeeeeeeeeeeeeeeeeeeeeeeeee
eeeeeeeeeeeeeeeeeeeeeeeeeeeeeeeeeeeeeeeeeeeeeeeeeeeeeeeeeeee
eeeeeeeeeeeeeeeeeeeeeeeeeeeeeeeeeeeeeeeeeeeeeeeeeeeeeeeeeeee
eeeeeeeeeeeeeeeeeeeeeeeeeeeeeeeeeeeeeeeeeeeeeeeeeeeeeeeeeeee
eeeeeeeeeeeeeeeeeeeeeeeeeeeeeeeeeeeeeeeeeeeeeeeeeeeeeeeeeeee
eeeeeeeeeeeeeeeeeeeeeeeeeeeeeeeeeeeeeeeeeeeeeeeeeeeeeeeeeeee
eeeeeeeeeeeeeeeeeeeeeeeeeeeeeeeeeeeeeeeeeeeeeeeeeeeeeeeeeeee
eeeeeeeeeeeeeeeeeeeeeeeeeeeeeeeeeeeeeeeeeeeeeeeeeeeeeeeeeeee
eeeeeeeeeeeeeeeeeeeeeeeeeeeeeeeeeeeeeeeeeeeeeeeeeeeeeeeeeeee
eeeeeeeeeeeeeeeeeeeeeeeeeeeeeeeeeeeeeeeeeeeeeeeeeeeeeeeeeeee
eeeeeeeeeeeeeeeeeeeeeeeeeeeeeeeeeeeeeeeeeeeeeeeeeeeeeeeeeeee
eeeeeeeeeeeeeeeeeeeeeeeeeeeeeeeeeeeeeeeeeeeeeeeeeeeeeeeeeeee
eeeeeeeeeeeeeeeeeeeeeeeeeeeeeeeeeeeeeeeeeeeeeeeeeeeeeeeeeeee
eeeeeeeeeeeeeeeeeeeeeeeeeeeeeeeeeeeeeeeeeeeeeeeeeeeeeeeeeeee
eeeeeeeeeeeeeeeeeeeeeeeeeeeeeeeeeeeeeeeeeeeeeeeeeeeeeeeeeeee
eeeeeeeeeeeeeeeeeeeeeeeeeeeeeeeeeeeeeeeeeeeeeeeeeeeeeeeeeeee
eeeeeeeeeeeeeeeeeeeeeeeeeeeeeeeeeeeeeeeeeeeeeeeeeeeeeeeeeeee
eeeeeeeeeeeeeeeeeeeeeeeeeeeeeeeeeeeeeeeeeeeeeeeeeeeeeeeeeeee
eeeeeeeeeeeeeeeeeeeeeeeeeeeeeeeeeeeeeeeeeeeeeeeeeeeeeeeeeeee
eeeeeeeeeeeeeeeeeeeeeeeeeeeeeeeeeeeeeeeeeeeeeeeeeeeeeeeeeeee
eeeeeeeeeeeeeeeeLLLLLLLLLLLLLLLLLLLLLLLLLLeeeeeeeeeeeeeeeeee
eeeeeeeeeeeeeeeeLggggLLLLLLLLLLLLLLLLggggLeeeeeeeeeeeeeeeeee
eeeeeeeeeeeeeeeeLggggLLLLLLLLLLLLLLLLggggLeeeeeeeeeeeeeeeeee
eeeeeeeeeeeeeeeenggggnLLnnHHnnHHnnLLnggggneeeeeeeeeeeeeeeeee
eeeeeeeeeeeeeeeenggggnLLnZuuTyuuZnLLnggggneeeeeeeeeeeeeeeeee
eeeeeeeeeeeeeeeenggggnLLnZuutFuuZnLLnggggneeeeeeeeeeeeeeeeee
eeeeeeeeeeeeeeeenggggnLLnZuurYuuZnLLnggggneeeeeeeeeeeeeeeeee
LLLLLLLLLLLLLLLLnggggnLLnZuuAhuuZnLLnggggnLLLLLLLLLLLLLLLLLL
LLLLLLLLLLLLLLLLngggfnnnnZuuWEuuZnnnnIgggnLLLLLLLLLLLLLLLLLL
LLLLLLLLLLLLLLLLnggggHzzHuuuuuuuuHzzHggggnLLLLLLLLLLLLLLLLLL
LLLLLLLLLLLLLLLLnggggHzzHuuuuuuuuHzzHggggnLLLLLLLLLLLLLLLLLL
LLLLLLLLLLLLLLLLngggfnnnnquuNOuupnnnnIgggnLLLLLLLLLLLLLLLLLL
LLLLLLLLLLLLLLLLnggggnLLnXuuSGuujnLLnggggnLLLLLLLLLLLLLLLLLL
LLLLLLLLLLLLLLLLnggggnLLnvuubCuucnLLnggggnLLLLLLLLLLLLLLLLLL
LLLLLLLLLLLLLLLLnggggnnnnnnQKKQnnnnnnggggnLLLLLLLLLLLLLLLLLL
LLLLLLLLLLLLLLLLngggggggsDnwwwwnPRgggggggnLLLLLLLLLLLLLLLLLL
LLLLLLLLLLLLLLLLngggggggsDnwUkwnPRgggggggnLLLLLLLLLLLLLLLLLL
LLLLLLLLLLLLLLLLngggggggsDnwkkwnPRgggggggnLLLLLLLLLLLLLLLLLL
LLLLLLLLLLLLLLLLnnnnnnnnnnnwwwwnnnnnnnnnnnLLLLLLLLLLLLLLLLLL
LLLLLLLLLLLLLLLLLLLLLLLLLLnnnnnnLLLLLLLLLLLLLLLLLLLLLLLLLLLL
LLLLLLLLLLLLLLLLLLLLLLLLLLLLLLLLLLLLLLLLLLLLLLLLLLLLLLLLLLLL
LLLLLLLLLLLLLLLLLLLLLLLLLLLLLLLLLLLLLLLLLLLLLLLLLLLLLLLLLLLL
LLLLLLLLLLLLLLLLLLLLLLLLLLLLLLLLLLLLLLLLLLLLLLLLLLLLLLLLLLLL
LLLLLLLLLLLLLLLLLLLLLLLLLLLLLLLLLLLLLLLLLLLLLLLLLLLLLLLLLLLL
LLLLLLLLLLLLLLLLLLLLLLLLLLLLLLLLLLLLLLLLLLLLLLLLLLLLLLLLLLLL
"}
(1,1,2) = {"
eeeeeeeeeeeeeeeeeeeeeeeeeeeeeeeeeeeeeeeeeeeeeeeeeeeeeeeeeeee
eeeeeeeeeeeeeeeeeeeeeeeeeeeeeeeeeeeeeeeeeeeeeeeeeeeeeeeeeeee
eeeeeeeeeeeeeeeeeeeeeeeeeeeeeeeeeeeeeeeeeeeeeeeeeeeeeeeeeeee
eeeeeeeeeeeeeeeeeeeeeeeeeeeeeeeeeeeeeeeeeeeeeeeeeeeeeeeeeeee
eeeeeeeeeeeeeeeeeeeeeeeeeeeeeeeeeeeeeeeeeeeeeeeeeeeeeeeeeeee
eeeeeeeeeeeeeeeeeeeeeeeeeeeeeeeeeeeeeeeeeeeeeeeeeeeeeeeeeeee
eeeeeeeeeeeeeeeeeeeeeeeeeeeeeeeeeeeeeeeeeeeeeeeeeeeeeeeeeeee
eeeeeeeeeeeeeeeeeeeeeeeeeeeeeeeeeeeeeeeeeeeeeeeeeeeeeeeeeeee
eeeeeeeeeeeeeeeeeeeeeeeeeeeeeeeeeeeeeeeeeeeeeeeeeeeeeeeeeeee
eeeeeeeeeeeeeeeeeeeeeeeeeeeeeeeeeeeeeeeeeeeeeeeeeeeeeeeeeeee
eeeeeeeeeeeeeeeeeeeeeeeeeeeeeeeeeeeeeeeeeeeeeeeeeeeeeeeeeeee
eeeeeeeeeeeeeeeeeeeeeeeeeeeeeeeeeeeeeeeeeeeeeeeeeeeeeeeeeeee
eeeeeeeeeeeeeeeeeeeeeeeeeeeeeeeeeeeeeeeeeeeeeeeeeeeeeeeeeeee
eeeeeeeeeeeeeeeeeeeeeeeeeeeeeeeeeeeeeeeeeeeeeeeeeeeeeeeeeeee
eeeeeeeeeeeeeeeeeeeeeeeeeeeeeeeeeeeeeeeeeeeeeeeeeeeeeeeeeeee
eeeeeeeeeeeeeeeeeeeeeeeeeeeeeeeeeeeeeeeeeeeeeeeeeeeeeeeeeeee
eeeeeeeeeeeeeeeeeeeeeeeeeeeeeeeeeeeeeeeeeeeeeeeeeeeeeeeeeeee
eeeeeeeeeeeeeeeeeeeeeeeeeeeeeeeeeeeeeeeeeeeeeeeeeeeeeeeeeeee
eeeeeeeeeeeeeeeeeeeeeeeeeeeeeeeeeeeeeeeeeeeeeeeeeeeeeeeeeeee
eeeeeeeeeeeeeeeeeeeeeeeeeeeeeeeeeeeeeeeeeeeeeeeeeeeeeeeeeeee
eeeeeeeeeeeeeeeeeeeeeeeeeeeeeeeeeeeeeeeeeeeeeeeeeeeeeeeeeeee
eeeeeeeeeeeeeeeeeeeeeeeeeeeeeeeeeeeeeeeeeeeeeeeeeeeeeeeeeeee
eeeeeeeeeeeeeeeeeeeeeeeeeeeeeeeeeeeeeeeeeeeeeeeeeeeeeeeeeeee
eeeeeeeeeeeeeeeeeeeeeeeeeeeeeeeeeeeeeeeeeeeeeeeeeeeeeeeeeeee
eeeeeeeeeeeeeeeeeeeeeeeeeeeeeeeeeeeeeeeeeeeeeeeeeeeeeeeeeeee
eeeeeeeeeeeeeeeeeeeeeeeeeeeeeeeeeeeeeeeeeeeeeeeeeeeeeeeeeeee
eeeeeeeeeeeeeeeeeeeeeeeeeeeeeeeeeeeeeeeeeeeeeeeeeeeeeeeeeeee
eeeeeeeeeeeeeeeeeeeeeeeeeeeeeeeeeeeeeeeeeeeeeeeeeeeeeeeeeeee
eeeeeeeeeeeeeeeeeeeeeeeeeeeeeeeeeeeeeeeeeeeeeeeeeeeeeeeeeeee
eeeeeeeeeeeeeeeeeeeeeeeeeeeeeeeeeeeeeeeeeeeeeeeeeeeeeeeeeeee
eeeeeeeeeeeeeeeeeeeeeeeeeeeeeeeeeeeeeeeeeeeeeeeeeeeeeeeeeeee
eeeeeeeeeeeeeeeeeeeeeeeeeeeeeeeeeeeeeeeeeeeeeeeeeeeeeeeeeeee
eeeeeeeeeeeeeeeeeeeeeeeeeeeeeeeeeeeeeeeeeeeeeeeeeeeeeeeeeeee
eeeeeeeeeeeeeeeeeeeeeeeeeeeeeeeeeeeeeeeeeeeeeeeeeeeeeeeeeeee
eeeeeeeeeeeeeeeeeeeeeeeeeeeeeeeeeeeeeeeeeeeeeeeeeeeeeeeeeeee
eeeeeeeeeeeeeeeeeeeeeeeeeeeeeeeeeeeeeeeeeeeeeeeeeeeeeeeeeeee
eeeeeeeeeeeeeeeeeeeeeeeeeeeeeeeeeeeeeeeeeeeeeeeeeeeeeeeeeeee
eeeeeeeeeeeeeeeeeeeeeeeeeeeeeeeeeeeeeeeeeeeeeeeeeeeeeeeeeeee
eeeeeeeeeeeeeeeeeeeeeeeeeeeeeeeeeeeeeeeeeeeeeeeeeeeeeeeeeeee
eeeeeeeeeeeeeeeeeeeeeeeeeeeeeeeeeeeeeeeeeeeeeeeeeeeeeeeeeeee
eeeeeeeeeeeeeeeeeeeeeeeeeeeeeeeeeeeeeeeeeeeeeeeeeeeeeeeeeeee
eeeeeeeeeeeeeeeeeeeeeeeeeeeeeeeeeeeeeeeeeeeeeeeeeeeeeeeeeeee
eeeeeeeeeeeeeeeeeeeeeeeeeeeeeeeeeeeeeeeeeeeeeeeeeeeeeeeeeeee
eeeeeeeeeeeeeeeeeeeeeeeeeeeeeeeeeeeeeeeeeeeeeeeeeeeeeeeeeeee
eeeeeeeeeeeeeeeeeeeeeeeeeeeeeeeeeeeeeeeeeeeeeeeeeeeeeeeeeeee
eeeeeeeeeeeeeeeeeeeeeeeeeeeeeeeeeeeeeeeeeeeeeeeeeeeeeeeeeeee
eeeeeeeeeeeeeeeeeeeeeeeeeeeeeeeeeeeeeeeeeeeeeeeeeeeeeeeeeeee
eeeeeeeeeeeeeeeeeeeeeeeeeeeeeeeeeeeeeeeeeeeeeeeeeeeeeeeeeeee
LLLLLLLLLLLLLLLLLLLLLLLLLLLLLLLLLLLLLLLLLLLLLLLLLLLLLLLLLLLL
LLLLLLLLLLLLLLLLLLLLLLLLnnnwwwwnnnLLLLLLLLLLLLLLLLLLLLLLLLLL
LLLLLLLLLLLLLLLLLLLLLLLLnwwwwwwwwnLLLLLLLLLLLLLLLLLLLLLLLLLL
LLLLLLLLLLLLLLLLLLLLLLLLnwwwwwwwwnLLLLLLLLLLLLLLLLLLLLLLLLLL
LLLLLLLLLLLLLLLLLLLLLLLLnwwwwwwwwnLLLLLLLLLLLLLLLLLLLLLLLLLL
LLLLLLLLLLLLLLLLLLLLLLLLnwwwwwwwwnLLLLLLLLLLLLLLLLLLLLLLLLLL
LLLLLLLLLLLLLLLLLLLLLLLLnwwwwwwwwnLLLLLLLLLLLLLLLLLLLLLLLLLL
LLLLLLLLLLLLLLLLLLLLLLLLwwwwwwwwwwLLLLLLLLLLLLLLLLLLLLLLLLLL
LLLLLLLLLLLLLLLLLLLLLLLLwwwwwwwwwwLLLLLLLLLLLLLLLLLLLLLLLLLL
LLLLLLLLLLLLLLLLLLLLLLLLnwwwwwwwwnLLLLLLLLLLLLLLLLLLLLLLLLLL
LLLLLLLLLLLLLLLLLLLLLLLLnwwwwwwwwnLLLLLLLLLLLLLLLLLLLLLLLLLL
LLLLLLLLLLLLLLLLLLLLLLLLnnJinnJinnLLLLLLLLLLLLLLLLLLLLLLLLLL
LLLLLLLLLLLLLLLLLLLLLLLLBMwwwwwwVdLLLLLLLLLLLLLLLLLLLLLLLLLL
LLLLLLLLLLLLLLLLLLLLLLLLBMwwwwwwVdLLLLLLLLLLLLLLLLLLLLLLLLLL
LLLLLLLLLLLLLLLLLLLLLLLLBMwwwwwwVdLLLLLLLLLLLLLLLLLLLLLLLLLL
LLLLLLLLLLLLLLLLLLLLLLLLnnnnnnnnnnLLLLLLLLLLLLLLLLLLLLLLLLLL
LLLLLLLLLLLLLLLLLLLLLLLLiiiiiiiiiiLLLLLLLLLLLLLLLLLLLLLLLLLL
LLLLLLLLLLLLLLLLLLLLLLLLiiiiiiiiiiLLLLLLLLLLLLLLLLLLLLLLLLLL
LLLLLLLLLLLLLLLLLLLLLLLLiiiiiiiiiiLLLLLLLLLLLLLLLLLLLLLLLLLL
LLLLLLLLLLLLLLLLLLLLLLLLiiiiiiiiiiLLLLLLLLLLLLLLLLLLLLLLLLLL
LLLLLLLLLLLLLLLLLLLLLLLLiiiiiiiiiiLLLLLLLLLLLLLLLLLLLLLLLLLL
LLLLLLLLLLLLLLLLLLLLLLLLLLLLLLLLLLLLLLLLLLLLLLLLLLLLLLLLLLLL
"}
