"as" = (/obj/structure/table/rack,/obj/item/gun/projectile/automatic/wintermute,/obj/item/gun/projectile/automatic/wintermute,/obj/item/gun/projectile/automatic/wintermute,/obj/item/gun/projectile/automatic/wintermute,/turf/simulated/floor/tiled/dark/gray_platform,/area/space)
"bB" = (/obj/structure/table/rack,/obj/item/gun/projectile/automatic/straylight,/obj/item/gun/projectile/automatic/straylight,/obj/item/gun/projectile/automatic/straylight,/obj/item/gun/projectile/automatic/straylight,/turf/simulated/floor/tiled/dark/gray_platform,/area/space)
"dD" = (/turf/simulated/wall/r_wall,/area/space)
"dU" = (/obj/structure/sign/department/armory{pixel_x = 32},/turf/simulated/floor/tiled/dark/bluecorner,/area/space)
"gN" = (/obj/structure/table/rack,/obj/item/clothing/suit/armor/vest/full/ironhammer,/obj/item/clothing/suit/armor/vest/full/ironhammer,/obj/item/clothing/suit/armor/vest/full/ironhammer,/obj/item/clothing/suit/armor/vest/full/ironhammer,/turf/simulated/floor/tiled/dark/gray_platform,/area/space)
"ho" = (/obj/structure/multiz/stairs/active{dir = 4},/turf/space,/area/space)
"hC" = (/turf/simulated/floor/tiled/dark,/area/space)
"ja" = (/obj/machinery/door/airlock/security{name = "Armory"; req_access = list(1)},/turf/simulated/floor/tiled/dark/cargo,/area/space)
"jq" = (/obj/structure/table/rack,/obj/item/tool/hammer/sledgehammer/ironhammer,/obj/item/tool/hammer/sledgehammer/ironhammer,/obj/item/tool/hammer/sledgehammer/ironhammer,/obj/item/tool/hammer/sledgehammer/ironhammer,/turf/simulated/floor/tiled/dark/gray_platform,/area/space)
"jR" = (/obj/structure/table/rack,/obj/item/gun/projectile/shotgun/pump/grenade/lenar,/obj/item/gun/projectile/shotgun/pump/grenade/lenar,/obj/item/gun/projectile/shotgun/pump/grenade/lenar,/obj/item/gun/projectile/shotgun/pump/grenade/lenar,/turf/simulated/floor/tiled/dark/gray_platform,/area/space)
"jZ" = (/obj/structure/table/rack,/obj/item/gun/energy/plasma/cassad,/obj/item/gun/energy/plasma/cassad,/obj/item/gun/energy/plasma/cassad,/obj/item/gun/energy/plasma/cassad,/turf/simulated/floor/tiled/dark/gray_platform,/area/space)
"ml" = (/obj/structure/table/rack,/obj/item/gun/projectile/shotgun/pump/gladstone,/obj/item/gun/projectile/shotgun/pump/gladstone,/obj/item/gun/projectile/shotgun/pump/gladstone,/obj/item/gun/projectile/shotgun/pump/gladstone,/turf/simulated/floor/tiled/dark/gray_platform,/area/space)
"nf" = (/obj/structure/multiz/stairs/enter{dir = 8},/turf/space,/area/space)
"nI" = (/obj/structure/table/rack,/obj/item/clothing/suit/armor/bulletproof/ironhammer,/obj/item/clothing/suit/armor/bulletproof/ironhammer,/obj/item/clothing/suit/armor/bulletproof/ironhammer,/obj/item/clothing/suit/armor/bulletproof/ironhammer,/turf/simulated/floor/tiled/dark/gray_platform,/area/space)
"oR" = (/obj/structure/multiz/stairs/active{dir = 4},/turf/simulated/floor/dirt,/area/space)
"qd" = (/obj/structure/table/rack,/obj/item/clothing/suit/space/void/security/equipped,/obj/item/clothing/suit/space/void/security/equipped,/obj/item/clothing/suit/space/void/security/equipped,/obj/item/clothing/suit/space/void/security/equipped,/turf/simulated/floor/tiled/dark/gray_platform,/area/space)
"rF" = (/obj/structure/table/rack,/obj/item/gun/projectile/automatic/sol,/obj/item/gun/projectile/automatic/sol,/obj/item/gun/projectile/automatic/sol,/obj/item/gun/projectile/automatic/sol,/turf/simulated/floor/tiled/dark/gray_platform,/area/space)
"sn" = (/obj/structure/table/rack,/turf/simulated/floor/tiled/dark/gray_platform,/area/space)
"st" = (/turf/simulated/floor/tiled/dark/bluecorner,/area/space)
"tg" = (/obj/structure/table/rack,/obj/item/gun/projectile/automatic/molly,/obj/item/gun/projectile/automatic/molly,/obj/item/gun/projectile/automatic/molly,/obj/item/gun/projectile/automatic/molly,/turf/simulated/floor/tiled/dark/gray_platform,/area/space)
"tl" = (/obj/structure/multiz/stairs/active{dir = 8},/turf/simulated/floor/dirt,/area/space)
"uk" = (/turf/simulated/floor/tiled/dark/cargo,/area/space)
"uY" = (/turf/simulated/floor/tiled/dark/gray_perforated,/area/space)
"wg" = (/turf/simulated/mineral,/area/space)
"wr" = (/obj/structure/closet/secure_closet/personal/security,/turf/simulated/floor/tiled/dark/gray_platform,/area/space)
"xq" = (/turf/simulated/floor/asteroid,/area/space)
"zA" = (/obj/structure/multiz/stairs/enter{dir = 8},/turf/simulated/floor/dirt,/area/space)
"Ce" = (/obj/structure/table/rack,/obj/item/clothing/mask/gas/ihs,/obj/item/clothing/mask/gas/ihs,/obj/item/clothing/mask/gas/ihs,/obj/item/clothing/mask/gas/ihs,/turf/simulated/floor/tiled/dark/gray_platform,/area/space)
"Ek" = (/obj/machinery/door/airlock/multi_tile/metal{dir = 2},/turf/simulated/floor/tiled/dark/cargo,/area/space)
"Es" = (/turf/space,/area/space)
"EA" = (/turf/simulated/floor/tiled/white/cargo,/area/space)
"EG" = (/obj/machinery/door/airlock/multi_tile/metal,/turf/simulated/floor/tiled/dark/bluecorner,/area/space)
"EW" = (/obj/machinery/door/airlock/multi_tile/metal,/turf/simulated/floor/tiled/dark/cargo,/area/space)
"FN" = (/obj/machinery/door/airlock/multi_tile/glass,/turf/space,/area/space)
"GU" = (/obj/structure/multiz/stairs/active{dir = 8},/turf/space,/area/space)
"HN" = (/obj/structure/multiz/stairs/enter{dir = 4},/turf/space,/area/space)
"Ij" = (/obj/structure/table/rack,/obj/item/gun/projectile/shotgun/bull,/obj/item/gun/projectile/shotgun/bull,/obj/item/gun/projectile/shotgun/bull,/obj/item/gun/projectile/shotgun/bull,/turf/simulated/floor/tiled/dark/gray_platform,/area/space)
"Ks" = (/obj/structure/table/rack,/obj/item/clothing/head/armor/helmet/ironhammer,/obj/item/clothing/head/armor/helmet/ironhammer,/obj/item/clothing/head/armor/helmet/ironhammer,/obj/item/clothing/head/armor/helmet/ironhammer,/turf/simulated/floor/tiled/dark/gray_platform,/area/space)
"KD" = (/obj/structure/table/rack,/obj/item/clothing/mask/balaclava/tactical,/obj/item/clothing/mask/balaclava/tactical,/obj/item/clothing/mask/balaclava/tactical,/obj/item/clothing/mask/balaclava/tactical,/turf/simulated/floor/tiled/dark/gray_platform,/area/space)
"Mo" = (/obj/structure/sign/department/armory{pixel_x = -32},/turf/simulated/floor/tiled/dark/bluecorner,/area/space)
"PC" = (/obj/machinery/autolathe/loaded,/turf/simulated/floor/tiled/dark/gray_perforated,/area/space)
"PU" = (/obj/structure/table/rack,/obj/item/clothing/suit/armor/heavy/ironhammer,/obj/item/clothing/suit/armor/heavy/ironhammer,/obj/item/clothing/suit/armor/heavy/ironhammer,/obj/item/clothing/suit/armor/heavy/ironhammer,/turf/simulated/floor/tiled/dark/gray_platform,/area/space)
"QK" = (/obj/structure/multiz/stairs/enter{dir = 4},/turf/simulated/floor/dirt,/area/space)
"QO" = (/obj/structure/table/rack,/obj/item/gun/projectile/paco,/obj/item/gun/projectile/paco,/obj/item/gun/projectile/paco,/obj/item/gun/projectile/paco,/turf/simulated/floor/tiled/dark/gray_platform,/area/space)
"SB" = (/turf/simulated/floor/tiled/dark/gray_platform,/area/space)
"TK" = (/obj/structure/table/rack,/obj/item/gun/projectile/automatic/lmg/tk,/obj/item/gun/projectile/automatic/lmg/tk,/obj/item/gun/projectile/automatic/lmg/tk,/obj/item/gun/projectile/automatic/lmg/tk,/turf/simulated/floor/tiled/dark/gray_platform,/area/space)
"Un" = (/turf/simulated/floor/tiled/steel/bluecorner,/area/space)
"Vg" = (/obj/structure/table/rack,/obj/item/clothing/head/armor/riot_hud,/obj/item/clothing/head/armor/riot_hud,/obj/item/clothing/head/armor/riot_hud,/obj/item/clothing/head/armor/riot_hud,/turf/simulated/floor/tiled/dark/gray_platform,/area/space)
"Wk" = (/obj/effect/window_lwall_spawn/reinforced,/turf/simulated/floor/plating,/area/space)
"WE" = (/obj/structure/closet/secure_closet/detective,/turf/simulated/floor/tiled/dark/gray_platform,/area/space)
"Xe" = (/obj/structure/table/rack,/obj/item/gun/projectile/lamia,/obj/item/gun/projectile/lamia,/obj/item/gun/projectile/lamia,/obj/item/gun/projectile/lamia,/turf/simulated/floor/tiled/dark/gray_platform,/area/space)
"Xh" = (/obj/structure/table/rack,/obj/item/clothing/head/armor/bulletproof/ironhammer_full,/obj/item/clothing/head/armor/bulletproof/ironhammer_full,/obj/item/clothing/head/armor/bulletproof/ironhammer_full,/obj/item/clothing/head/armor/bulletproof/ironhammer_full,/turf/simulated/floor/tiled/dark/gray_platform,/area/space)
"YJ" = (/obj/structure/table/rack,/obj/item/clothing/suit/storage/vest/ironhammer,/obj/item/clothing/suit/storage/vest/ironhammer,/obj/item/clothing/suit/storage/vest/ironhammer,/obj/item/clothing/suit/storage/vest/ironhammer,/turf/simulated/floor/tiled/dark/gray_platform,/area/space)

(1,1,1) = {"
wgwgwgwgwgwgwgwgwgwgwgwgwgwgwgwgwgwgwgwgwgwgwgwgwgwgwgwgwgwgwgwgwgwgwgwgwgwgwgwgwgwgwgwgwgwgwgwgwgwgwgwgwgwgwgwgwgwgwgwg
wgwgwgwgwgwgwgwgwgwgwgwgwgwgwgwgwgwgwgwgwgwgwgwgwgwgwgwgwgwgwgwgwgwgwgwgwgwgwgwgwgwgwgwgwgwgwgwgwgwgwgwgwgwgwgwgwgwgwgwg
wgwgwgwgwgwgwgwgwgwgwgwgwgwgwgwgwgwgwgwgwgwgwgwgwgwgwgwgwgwgwgwgwgwgwgwgwgwgwgwgwgwgwgwgwgwgwgwgwgwgwgwgwgwgwgwgwgwgwgwg
wgwgwgwgwgwgwgwgwgwgwgwgwgwgwgwgwgwgwgwgwgwgwgwgwgwgwgwgwgwgwgwgwgwgwgwgwgwgwgwgwgwgwgwgwgwgwgwgwgwgwgwgwgwgwgwgwgwgwgwg
wgwgwgwgwgwgwgwgwgwgwgwgwgwgwgwgwgwgwgwgwgwgwgwgwgwgwgwgwgwgwgwgwgwgwgwgwgwgwgwgwgwgwgwgwgwgwgwgwgwgwgwgwgwgwgwgwgwgwgwg
wgwgwgwgwgwgwgwgwgwgwgwgwgwgwgwgwgwgwgwgwgwgwgwgwgwgwgwgwgwgwgwgwgwgwgwgwgwgwgwgwgwgwgwgwgwgwgwgwgwgwgwgwgwgwgwgwgwgwgwg
wgwgwgwgwgwgwgwgwgwgwgwgwgwgwgwgwgwgwgwgwgwgwgwgwgwgwgwgwgwgwgwgwgwgwgwgwgwgwgwgwgwgwgwgwgwgwgwgwgwgwgwgwgwgwgwgwgwgwgwg
wgwgwgwgwgwgwgwgwgwgwgwgwgwgwgwgwgwgwgwgwgwgwgwgwgwgwgwgwgwgwgwgwgwgwgwgwgwgwgwgwgwgwgwgwgwgwgwgwgwgwgwgwgwgwgwgwgwgwgwg
wgwgwgwgwgwgwgwgwgwgwgwgwgwgwgwgwgwgwgwgwgwgwgwgwgwgwgwgwgwgwgwgwgwgwgwgwgwgwgwgwgwgwgwgwgwgwgwgwgwgwgwgwgwgwgwgwgwgwgwg
wgwgwgwgwgwgwgwgwgwgwgwgwgwgwgwgwgwgwgwgwgwgwgwgwgwgwgwgwgwgwgwgwgwgwgwgwgwgwgwgwgwgwgwgwgwgwgwgwgwgwgwgwgwgwgwgwgwgwgwg
wgwgwgwgwgwgwgwgwgwgwgwgwgwgwgwgwgwgwgwgwgwgwgwgwgwgwgwgwgwgwgwgwgwgwgwgwgwgwgwgwgwgwgwgwgwgwgwgwgwgwgwgwgwgwgwgwgwgwgwg
wgwgwgwgwgwgwgwgwgwgwgwgwgwgwgwgwgwgwgwgwgwgwgwgwgwgwgwgwgwgwgwgwgwgwgwgwgwgwgwgwgwgwgwgwgwgwgwgwgwgwgwgwgwgwgwgwgwgwgwg
wgwgwgwgwgwgwgwgwgwgwgwgwgwgwgwgwgwgwgwgwgwgwgwgwgwgwgwgwgwgwgwgwgwgwgwgwgwgwgwgwgwgwgwgwgwgwgwgwgwgwgwgwgwgwgwgwgwgwgwg
wgwgwgwgwgwgwgwgwgwgwgwgwgwgwgwgwgwgwgwgwgwgwgwgwgwgwgwgwgwgwgwgwgwgwgwgwgwgwgwgwgwgwgwgwgwgwgwgwgwgwgwgwgwgwgwgwgwgwgwg
wgwgwgwgwgwgwgwgwgwgwgwgwgwgwgwgwgwgwgwgwgwgwgwgwgwgwgwgwgwgwgwgwgwgwgwgwgwgwgwgwgwgwgwgwgwgwgwgwgwgwgwgwgwgwgwgwgwgwgwg
wgwgwgwgwgwgwgwgwgwgwgwgwgwgwgwgwgwgwgwgwgwgwgwgwgwgwgwgwgwgwgwgwgwgwgwgwgwgwgwgwgwgwgwgwgwgwgwgwgwgwgwgwgwgwgwgwgwgwgwg
wgwgwgwgwgwgwgwgwgwgwgwgwgwgwgwgwgwgwgwgwgwgwgwgwgwgwgwgwgwgwgwgwgwgwgwgwgwgwgwgwgwgwgwgwgwgwgwgwgwgwgwgwgwgwgwgwgwgwgwg
wgwgwgwgwgwgwgwgwgwgwgwgwgwgwgwgwgwgwgwgwgwgwgwgwgwgwgwgwgwgwgwgwgwgwgwgwgwgwgwgwgwgwgwgwgwgwgwgwgwgwgwgwgwgwgwgwgwgwgwg
wgwgwgwgwgwgwgwgwgwgwgwgwgwgwgwgwgwgwgwgwgwgwgwgwgwgwgwgwgwgwgwgwgwgwgwgwgwgwgwgwgwgwgwgwgwgwgwgwgwgwgwgwgwgwgwgwgwgwgwg
wgwgwgwgwgwgwgwgwgwgwgwgwgwgwgwgwgwgwgwgwgwgwgwgwgwgwgwgwgwgwgwgwgwgwgwgwgwgwgwgwgwgwgwgwgwgwgwgwgwgwgwgwgwgwgwgwgwgwgwg
wgwgwgwgwgwgwgwgwgwgwgwgwgwgwgwgwgwgwgwgwgwgwgwgwgwgwgwgwgwgwgwgwgwgwgwgwgwgwgwgwgwgwgwgwgwgwgwgwgwgwgwgwgwgwgwgwgwgwgwg
wgwgwgwgwgwgwgwgwgwgwgwgwgwgwgwgwgwgwgwgwgwgwgwgwgwgwgwgwgwgwgwgwgwgwgwgwgwgwgwgwgwgwgwgwgwgwgwgwgwgwgwgwgwgwgwgwgwgwgwg
wgwgwgwgwgwgwgwgwgwgwgwgwgwgwgwgwgwgwgwgwgwgwgwgwgwgwgwgwgwgwgwgwgwgwgwgwgwgwgwgwgwgwgwgwgwgwgwgwgwgwgwgwgwgwgwgwgwgwgwg
wgwgwgwgwgwgwgwgwgwgwgwgwgwgwgwgwgwgwgwgwgwgwgwgwgwgwgwgwgwgwgwgwgwgwgwgwgwgwgwgwgwgwgwgwgwgwgwgwgwgwgwgwgwgwgwgwgwgwgwg
wgwgwgwgwgwgwgwgwgwgwgwgwgwgwgwgwgwgwgwgwgwgwgwgwgwgwgwgwgwgwgwgwgwgwgwgwgwgwgwgwgwgwgwgwgwgwgwgwgwgwgwgwgwgwgwgwgwgwgwg
wgwgwgwgwgwgwgwgwgwgwgwgwgwgwgwgwgwgwgwgwgwgwgwgwgwgwgwgwgwgwgwgwgwgwgwgwgwgwgwgwgwgwgwgwgwgwgwgwgwgwgwgwgwgwgwgwgwgwgwg
wgwgwgwgwgwgwgwgwgwgwgwgwgwgwgwgwgwgwgwgwgwgwgwgwgwgwgwgwgwgwgwgwgwgwgwgwgwgwgwgwgwgwgwgwgwgwgwgwgwgwgwgwgwgwgwgwgwgwgwg
wgwgwgwgwgwgwgwgwgwgwgwgwgwgwgwgwgwgwgwgwgwgwgwgwgwgwgwgwgwgwgwgwgwgwgwgwgwgwgwgwgwgwgwgwgwgwgwgwgwgwgwgwgwgwgwgwgwgwgwg
wgwgwgwgwgwgwgwgwgwgwgwgwgwgwgwgwgwgwgwgwgwgwgwgwgwgwgwgwgwgwgwgwgwgwgwgwgwgwgwgwgwgwgwgwgwgwgwgwgwgwgwgwgwgwgwgwgwgwgwg
wgwgwgwgwgwgwgwgwgwgwgwgwgwgwgwgwgwgwgwgwgwgwgwgwgwgwgwgwgwgwgwgwgwgwgwgwgwgwgwgwgwgwgwgwgwgwgwgwgwgwgwgwgwgwgwgwgwgwgwg
wgwgwgwgwgwgwgwgwgwgwgwgwgwgwgwgwgwgwgwgwgwgwgwgwgwgwgwgwgwgwgwgwgwgwgwgwgwgwgwgwgwgwgwgwgwgwgwgwgwgwgwgwgwgwgwgwgwgwgwg
wgwgwgwgwgwgwgwgwgwgwgwgwgwgwgwgwgwgwgwgwgwgwgwgwgwgwgwgwgwgwgwgwgwgwgwgwgwgwgwgwgwgwgwgwgwgwgwgwgwgwgwgwgwgwgwgwgwgwgwg
wgwgwgwgwgwgwgwgwgwgwgwgwgwgwgwgwgwgwgwgwgwgwgwgwgwgwgwgwgwgwgwgwgwgwgwgwgwgwgwgwgwgwgwgwgwgwgwgwgwgwgwgwgwgwgwgwgwgwgwg
wgwgwgwgwgwgwgwgwgwgwgwgwgwgwgwgwgdDstststdDwgwgwgwgwgwgwgwgwgwgwgwgwgwgdDstststdDwgwgwgwgwgwgwgwgwgwgwgwgwgwgwgwgwgwgwg
wgwgwgwgwgwgwgwgwgwgwgwgwgwgwgwgwgdDstststdDwgwgwgwgwgwgwgwgwgwgwgwgwgwgdDstststdDwgwgwgwgwgwgwgwgwgwgwgwgwgwgwgwgwgwgwg
wgwgwgwgwgwgwgwgwgwgwgwgwgwgwgwgwgdDstststdDwgdDdDEGstdDdDdDdDEGstdDdDwgdDstststdDwgwgwgwgwgwgwgwgwgwgwgwgwgwgwgwgwgwgwg
wgwgwgwgwgwgwgwgwgwgwgwgwgwgwgwgwgdDstststdDwgdDwrststwrdDdDwrststwrdDwgdDstststdDwgwgwgwgwgwgwgwgwgwgwgwgwgwgwgwgwgwgwg
wgwgwgwgwgwgwgwgwgwgwgwgwgwgwgwgwgdDstststdDwgdDwrststwrdDdDwrststwrdDwgdDstststdDwgwgwgwgwgwgwgwgwgwgwgwgwgwgwgwgwgwgwg
wgwgwgwgwgwgwgwgwgwgwgwgwgwgwgwgwgdDstststdDwgdDwrststwrdDdDwrststwrdDwgdDstststdDwgwgwgwgwgwgwgwgwgwgwgwgwgwgwgwgwgwgwg
wgwgwgwgwgwgwgwgwgwgwgwgwgwgwgwgwgdDstststdDwgdDwrststwrdDdDwrststwrdDwgdDstststdDwgwgwgwgwgwgwgwgwgwgwgwgwgwgwgwgwgwgwg
wgwgwgwgwgwgwgwgwgwgwgwgwgwgwgwgwgdDstststdDwgdDwrststwrdDdDwrststwrdDwgdDstststdDwgwgwgwgwgwgwgwgwgwgwgwgwgwgwgwgwgwgwg
wgwgwgwgwgwgwgwgwgwgwgwgwgwgwgwgwgdDstststdDwgdDwrststwrdDdDwrststwrdDwgdDstststdDwgwgwgwgwgwgwgwgwgwgwgwgwgwgwgwgwgwgwg
wgwgwgwgwgwgwgwgwgwgwgwgwgwgwgwgwgdDstststdDwgdDwrststwrdDdDwrststwrdDwgdDstststdDwgwgwgwgwgwgwgwgwgwgwgwgwgwgwgwgwgwgwg
wgwgwgwgwgwgwgwgwgwgwgwgwgwgwgwgxqdDstststdDwgdDdDEGstdDdDdDdDEGstdDdDwgdDstststdDxqwgwgwgwgwgwgwgwgwgwgwgwgwgwgwgwgwgwg
wgwgwgwgwgwgwgwgwgwgwgwgwgwgwgwgxqdDstststdDwgdDWEstststdDdDstststWEdDwgdDstststdDxqwgwgwgwgwgwgwgwgwgwgwgwgwgwgwgwgwgwg
wgwgwgwgwgwgwgwgwgwgwgwgwgwgwgwgxqdDstststdDwgdDdDSBststststststSBdDdDwgdDstststdDxqwgwgwgwgwgwgwgwgwgwgwgwgwgwgwgwgwgwg
wgwgwgwgwgwgwgwgwgwgwgwgwgwgwgwgxqdDstststdDwgwgdDSBststststststSBdDwgwgdDstststdDxqwgwgwgwgwgwgwgwgwgwgwgwgwgwgwgwgwgwg
wgwgwgwgwgwgwgwgwgwgwgwgwgwgwgwgxqdDstststdDwgwgdDSBststSBSBststSBdDwgwgdDstststdDxqwgwgwgwgwgwgwgwgwgwgwgwgwgwgwgwgwgwg
wgwgwgwgwgwgwgwgwgwgwgwgwgwgwgwgxqdDstststdDwgwgdDdDEWukdDdDEWukdDdDwgwgdDstststdDxqwgwgwgwgwgwgwgwgwgwgwgwgwgwgwgwgwgwg
wgwgwgwgwgwgwgwgwgwgwgwgwgwgwgwgxqdDstststdDwgwgdDsnUnUnCeqdUnUnsndDwgwgdDstststdDxqwgwgwgwgwgwgwgwgwgwgwgwgwgwgwgwgwgwg
wgwgwgwgwgwgwgwgwgwgwgwgwgwgwgwgxqdDstststdDwgwgdDsnUnUnVgPUUnUnsndDwgwgdDstststdDxqwgwgwgwgwgwgwgwgwgwgwgwgwgwgwgwgwgwg
wgwgwgwgwgwgwgwgwgwgwgwgwgwgwgwgxqdDstststdDwgwgdDsnUnUnXhnIUnUnsndDwgwgdDstststdDxqwgwgwgwgwgwgwgwgwgwgwgwgwgwgwgwgwgwg
xqxqxqxqxqxqxqxqxqxqxqxqxqxqxqxqxqdDstststdDwgwgdDsnUnUnKsgNUnUnsndDwgwgdDstststdDxqxqxqxqxqxqxqxqxqxqxqxqxqxqxqxqxqxqxq
xqxqxqxqxqxqxqxqxqxqxqxqxqxqxqxqxqdDststdUdDdDdDdDsnUnUnKDYJUnUnsndDdDdDdDMoststdDxqxqxqxqxqxqxqxqxqxqxqxqxqxqxqxqxqxqxq
xqxqxqxqxqxqxqxqxqxqxqxqxqxqxqxqxqdDstststukEAEAukUnUnUnUnUnUnUnUnukEAEAukstststdDxqxqxqxqxqxqxqxqxqxqxqxqxqxqxqxqxqxqxq
xqxqxqxqxqxqxqxqxqxqxqxqxqxqxqxqxqdDstststEkEAEAEkUnUnUnUnUnUnUnUnEkEAEAEkstststdDxqxqxqxqxqxqxqxqxqxqxqxqxqxqxqxqxqxqxq
xqxqxqxqxqxqxqxqxqxqxqxqxqxqxqxqxqdDststdUdDWkWkdDasUnUnjRjZUnUntgdDWkWkdDMoststdDxqxqxqxqxqxqxqxqxqxqxqxqxqxqxqxqxqxqxq
xqxqxqxqxqxqxqxqxqxqxqxqxqxqxqxqxqdDstststdDxqxqdDrFUnUnTKmlUnUnQOdDxqxqdDstststdDxqxqxqxqxqxqxqxqxqxqxqxqxqxqxqxqxqxqxq
xqxqxqxqxqxqxqxqxqxqxqxqxqxqxqxqxqdDstststdDxqxqdDbBUnUnjqIjUnUnXedDxqxqdDstststdDxqxqxqxqxqxqxqxqxqxqxqxqxqxqxqxqxqxqxq
xqxqxqxqxqxqxqxqxqxqxqxqxqxqxqxqxqdDstststdDWkWkdDdDdDjaWkWkjadDdDdDWkWkdDstststdDxqxqxqxqxqxqxqxqxqxqxqxqxqxqxqxqxqxqxq
xqxqxqxqxqxqxqxqxqxqxqxqxqxqxqxqxqdDststststststzAtldDhChChChCdDoRQKststststststdDxqxqxqxqxqxqxqxqxqxqxqxqxqxqxqxqxqxqxq
xqxqxqxqxqxqxqxqxqxqxqxqxqxqxqxqxqdDststststststzAtldDhCPCuYhCdDoRQKststststststdDxqxqxqxqxqxqxqxqxqxqxqxqxqxqxqxqxqxqxq
xqxqxqxqxqxqxqxqxqxqxqxqxqxqxqxqxqdDststststststzAtldDhCuYuYhCdDoRQKststststststdDxqxqxqxqxqxqxqxqxqxqxqxqxqxqxqxqxqxqxq
xqxqxqxqxqxqxqxqxqxqxqxqxqxqxqxqxqdDdDdDdDdDdDdDdDdDdDhChChChCdDdDdDdDdDdDdDdDdDdDxqxqxqxqxqxqxqxqxqxqxqxqxqxqxqxqxqxqxq
xqxqxqxqxqxqxqxqxqxqxqxqxqxqxqxqxqxqxqxqxqxqxqxqxqxqdDdDdDdDdDdDxqxqxqxqxqxqxqxqxqxqxqxqxqxqxqxqxqxqxqxqxqxqxqxqxqxqxqxq
xqxqxqxqxqxqxqxqxqxqxqxqxqxqxqxqxqxqxqxqxqxqxqxqxqxqxqxqxqxqxqxqxqxqxqxqxqxqxqxqxqxqxqxqxqxqxqxqxqxqxqxqxqxqxqxqxqxqxqxq
xqxqxqxqxqxqxqxqxqxqxqxqxqxqxqxqxqxqxqxqxqxqxqxqxqxqxqxqxqxqxqxqxqxqxqxqxqxqxqxqxqxqxqxqxqxqxqxqxqxqxqxqxqxqxqxqxqxqxqxq
xqxqxqxqxqxqxqxqxqxqxqxqxqxqxqxqxqxqxqxqxqxqxqxqxqxqxqxqxqxqxqxqxqxqxqxqxqxqxqxqxqxqxqxqxqxqxqxqxqxqxqxqxqxqxqxqxqxqxqxq
xqxqxqxqxqxqxqxqxqxqxqxqxqxqxqxqxqxqxqxqxqxqxqxqxqxqxqxqxqxqxqxqxqxqxqxqxqxqxqxqxqxqxqxqxqxqxqxqxqxqxqxqxqxqxqxqxqxqxqxq
xqxqxqxqxqxqxqxqxqxqxqxqxqxqxqxqxqxqxqxqxqxqxqxqxqxqxqxqxqxqxqxqxqxqxqxqxqxqxqxqxqxqxqxqxqxqxqxqxqxqxqxqxqxqxqxqxqxqxqxq
"}
(1,1,2) = {"
wgwgwgwgwgwgwgwgwgwgwgwgwgwgwgwgwgwgwgwgwgwgwgwgwgwgwgwgwgwgwgwgwgwgwgwgwgwgwgwgwgwgwgwgwgwgwgwgwgwgwgwgwgwgwgwgwgwgwgwg
wgwgwgwgwgwgwgwgwgwgwgwgwgwgwgwgwgwgwgwgwgwgwgwgwgwgwgwgwgwgwgwgwgwgwgwgwgwgwgwgwgwgwgwgwgwgwgwgwgwgwgwgwgwgwgwgwgwgwgwg
wgwgwgwgwgwgwgwgwgwgwgwgwgwgwgwgwgwgwgwgwgwgwgwgwgwgwgwgwgwgwgwgwgwgwgwgwgwgwgwgwgwgwgwgwgwgwgwgwgwgwgwgwgwgwgwgwgwgwgwg
wgwgwgwgwgwgwgwgwgwgwgwgwgwgwgwgwgwgwgwgwgwgwgwgwgwgwgwgwgwgwgwgwgwgwgwgwgwgwgwgwgwgwgwgwgwgwgwgwgwgwgwgwgwgwgwgwgwgwgwg
wgwgwgwgwgwgwgwgwgwgwgwgwgwgwgwgwgwgwgwgwgwgwgwgwgwgwgwgwgwgwgwgwgwgwgwgwgwgwgwgwgwgwgwgwgwgwgwgwgwgwgwgwgwgwgwgwgwgwgwg
wgwgwgwgwgwgwgwgwgwgwgwgwgwgwgwgwgwgwgwgwgwgwgwgwgwgwgwgwgwgwgwgwgwgwgwgwgwgwgwgwgwgwgwgwgwgwgwgwgwgwgwgwgwgwgwgwgwgwgwg
wgwgwgwgwgwgwgwgwgwgwgwgwgwgwgwgwgwgwgwgwgwgwgwgwgwgwgwgwgwgwgwgwgwgwgwgwgwgwgwgwgwgwgwgwgwgwgwgwgwgwgwgwgwgwgwgwgwgwgwg
wgwgwgwgwgwgwgwgwgwgwgwgwgwgwgwgwgwgwgwgwgwgwgwgwgwgwgwgwgwgwgwgwgwgwgwgwgwgwgwgwgwgwgwgwgwgwgwgwgwgwgwgwgwgwgwgwgwgwgwg
wgwgwgwgwgwgwgwgwgwgwgwgwgwgwgwgwgwgwgwgwgwgwgwgwgwgwgwgwgwgwgwgwgwgwgwgwgwgwgwgwgwgwgwgwgwgwgwgwgwgwgwgwgwgwgwgwgwgwgwg
wgwgwgwgwgwgwgwgwgwgwgwgwgwgwgwgwgwgwgwgwgwgwgwgwgwgwgwgwgwgwgwgwgwgwgwgwgwgwgwgwgwgwgwgwgwgwgwgwgwgwgwgwgwgwgwgwgwgwgwg
wgwgwgwgwgwgwgwgwgwgwgwgwgwgwgwgwgwgwgwgwgwgwgwgwgwgwgwgwgwgwgwgwgwgwgwgwgwgwgwgwgwgwgwgwgwgwgwgwgwgwgwgwgwgwgwgwgwgwgwg
wgwgwgwgwgwgwgwgwgwgwgwgwgwgwgwgwgwgwgwgwgwgwgwgwgwgwgwgwgwgwgwgwgwgwgwgwgwgwgwgwgwgwgwgwgwgwgwgwgwgwgwgwgwgwgwgwgwgwgwg
wgwgwgwgwgwgwgwgwgwgwgwgwgwgwgwgwgwgwgwgwgwgwgwgwgwgwgwgwgwgwgwgwgwgwgwgwgwgwgwgwgwgwgwgwgwgwgwgwgwgwgwgwgwgwgwgwgwgwgwg
wgwgwgwgwgwgwgwgwgwgwgwgwgwgwgwgwgwgwgwgwgwgwgwgwgwgwgwgwgwgwgwgwgwgwgwgwgwgwgwgwgwgwgwgwgwgwgwgwgwgwgwgwgwgwgwgwgwgwgwg
wgwgwgwgwgwgwgwgwgwgwgwgwgwgwgwgwgwgwgwgwgwgwgwgwgwgwgwgwgwgwgwgwgwgwgwgwgwgwgwgwgwgwgwgwgwgwgwgwgwgwgwgwgwgwgwgwgwgwgwg
wgwgwgwgwgwgwgwgwgwgwgwgwgwgwgwgwgwgwgwgwgwgwgwgwgwgwgwgwgwgwgwgwgwgwgwgwgwgwgwgwgwgwgwgwgwgwgwgwgwgwgwgwgwgwgwgwgwgwgwg
wgwgwgwgwgwgwgwgwgwgwgwgwgwgwgwgwgwgwgwgwgwgwgwgwgwgwgwgwgwgwgwgwgwgwgwgwgwgwgwgwgwgwgwgwgwgwgwgwgwgwgwgwgwgwgwgwgwgwgwg
wgwgwgwgwgwgwgwgwgwgwgwgwgwgwgwgwgwgwgwgwgwgwgwgwgwgwgwgwgwgwgwgwgwgwgwgwgwgwgwgwgwgwgwgwgwgwgwgwgwgwgwgwgwgwgwgwgwgwgwg
wgwgwgwgwgwgwgwgwgwgwgwgwgwgwgwgwgwgwgwgwgwgwgwgwgwgwgwgwgwgwgwgwgwgwgwgwgwgwgwgwgwgwgwgwgwgwgwgwgwgwgwgwgwgwgwgwgwgwgwg
wgwgwgwgwgwgwgwgwgwgwgwgwgwgwgwgwgwgwgwgwgwgwgwgwgwgwgwgwgwgwgwgwgwgwgwgwgwgwgwgwgwgwgwgwgwgwgwgwgwgwgwgwgwgwgwgwgwgwgwg
wgwgwgwgwgwgwgwgwgwgwgwgwgwgwgwgwgwgwgwgwgwgwgwgwgwgwgwgwgwgwgwgwgwgwgwgwgwgwgwgwgwgwgwgwgwgwgwgwgwgwgwgwgwgwgwgwgwgwgwg
wgwgwgwgwgwgwgwgwgwgwgwgwgwgwgwgwgwgwgwgwgwgwgwgwgwgwgwgwgwgwgwgwgwgwgwgwgwgwgwgwgwgwgwgwgwgwgwgwgwgwgwgwgwgwgwgwgwgwgwg
wgwgwgwgwgwgwgwgwgwgwgwgwgwgwgwgwgwgwgwgwgwgwgwgwgwgwgwgwgwgwgwgwgwgwgwgwgwgwgwgwgwgwgwgwgwgwgwgwgwgwgwgwgwgwgwgwgwgwgwg
wgwgwgwgwgwgwgwgwgwgwgwgwgwgwgwgwgwgwgwgwgwgwgwgwgwgwgwgwgwgwgwgwgwgwgwgwgwgwgwgwgwgwgwgwgwgwgwgwgwgwgwgwgwgwgwgwgwgwgwg
wgwgwgwgwgwgwgwgwgwgwgwgwgwgwgwgwgwgwgwgwgwgwgwgwgwgwgwgwgwgwgwgwgwgwgwgwgwgwgwgwgwgwgwgwgwgwgwgwgwgwgwgwgwgwgwgwgwgwgwg
wgwgwgwgwgwgwgwgwgwgwgwgwgwgwgwgwgwgwgwgwgwgwgwgwgwgwgwgwgwgwgwgwgwgwgwgwgwgwgwgwgwgwgwgwgwgwgwgwgwgwgwgwgwgwgwgwgwgwgwg
wgwgwgwgwgwgwgwgwgwgwgwgwgwgwgwgwgwgwgwgwgwgwgwgwgwgwgwgwgwgwgwgwgwgwgwgwgwgwgwgwgwgwgwgwgwgwgwgwgwgwgwgwgwgwgwgwgwgwgwg
wgwgwgwgwgwgwgwgwgwgwgwgwgwgwgwgwgwgwgwgwgwgwgwgwgwgwgwgwgwgwgwgwgwgwgwgwgwgwgwgwgwgwgwgwgwgwgwgwgwgwgwgwgwgwgwgwgwgwgwg
wgwgwgwgwgwgwgwgwgwgwgwgwgwgwgwgwgwgwgwgwgwgwgwgwgwgwgwgwgwgwgwgwgwgwgwgwgwgwgwgwgwgwgwgwgwgwgwgwgwgwgwgwgwgwgwgwgwgwgwg
wgwgwgwgwgwgwgwgwgwgwgwgwgwgwgwgwgwgwgwgwgwgwgwgwgwgwgwgwgwgwgwgwgwgwgwgwgwgwgwgwgwgwgwgwgwgwgwgwgwgwgwgwgwgwgwgwgwgwgwg
wgwgwgwgwgwgwgwgwgwgwgwgwgwgwgwgwgwgwgwgwgwgwgwgwgwgwgwgwgwgwgwgwgwgwgwgwgwgwgwgwgwgwgwgwgwgwgwgwgwgwgwgwgwgwgwgwgwgwgwg
wgwgwgwgwgwgwgwgwgwgwgwgwgwgwgwgwgwgwgwgwgwgwgwgwgwgwgwgwgwgwgwgwgwgwgwgwgwgwgwgwgwgwgwgwgwgwgwgwgwgwgwgwgwgwgwgwgwgwgwg
wgwgwgwgwgwgwgwgwgwgwgwgwgwgwgwgwgwgwgwgwgwgwgwgwgwgwgwgwgwgwgwgwgwgwgwgwgwgwgwgwgwgwgwgwgwgwgwgwgwgwgwgwgwgwgwgwgwgwgwg
wgwgwgwgwgwgwgwgwgwgwgwgwgwgwgwgwgwgwgwgwgwgwgwgwgwgwgwgwgwgwgwgwgwgwgwgwgwgwgwgwgwgwgwgwgwgwgwgwgwgwgwgwgwgwgwgwgwgwgwg
wgwgwgwgwgwgwgwgwgwgwgwgwgwgwgwgwgwgwgwgwgwgwgwgwgwgwgwgwgwgwgwgwgwgwgwgwgwgwgwgwgwgwgwgwgwgwgwgwgwgwgwgwgwgwgwgwgwgwgwg
wgwgwgwgwgwgwgwgwgwgwgwgwgwgwgwgwgwgwgwgwgwgwgwgwgwgwgwgwgwgwgwgwgwgwgwgwgwgwgwgwgwgwgwgwgwgwgwgwgwgwgwgwgwgwgwgwgwgwgwg
wgwgwgwgwgwgwgwgwgwgwgwgwgwgwgwgwgwgwgwgwgwgwgwgwgwgwgwgwgwgwgwgwgwgwgwgwgwgwgwgwgwgwgwgwgwgwgwgwgwgwgwgwgwgwgwgwgwgwgwg
wgwgwgwgwgwgwgwgwgwgwgwgwgwgwgwgwgwgwgwgwgwgwgwgwgwgwgwgwgwgwgwgwgwgwgwgwgwgwgwgwgwgwgwgwgwgwgwgwgwgwgwgwgwgwgwgwgwgwgwg
wgwgwgwgwgwgwgwgwgwgwgwgwgwgwgwgwgwgwgwgwgwgwgwgwgwgwgwgwgwgwgwgwgwgwgwgwgwgwgwgwgwgwgwgwgwgwgwgwgwgwgwgwgwgwgwgwgwgwgwg
wgwgwgwgwgwgwgwgwgwgwgwgwgwgwgwgwgwgwgwgwgwgwgwgwgwgwgwgwgwgwgwgwgwgwgwgwgwgwgwgwgwgwgwgwgwgwgwgwgwgwgwgwgwgwgwgwgwgwgwg
wgwgwgwgwgwgwgwgwgwgwgwgwgwgwgwgwgwgwgwgwgwgwgwgwgwgwgwgwgwgwgwgwgwgwgwgwgwgwgwgwgwgwgwgwgwgwgwgwgwgwgwgwgwgwgwgwgwgwgwg
wgwgwgwgwgwgwgwgwgwgwgwgwgwgwgwgwgwgwgwgwgwgwgwgwgwgwgwgwgwgwgwgwgwgwgwgwgwgwgwgwgwgwgwgwgwgwgwgwgwgwgwgwgwgwgwgwgwgwgwg
wgwgwgwgwgwgwgwgwgwgwgwgwgwgwgwgwgwgwgwgwgwgwgwgwgwgwgwgwgwgwgwgwgwgwgwgwgwgwgwgwgwgwgwgwgwgwgwgwgwgwgwgwgwgwgwgwgwgwgwg
wgwgwgwgwgwgwgwgwgwgwgwgwgwgwgwgwgwgwgwgwgwgwgwgwgwgwgwgwgwgwgwgwgwgwgwgwgwgwgwgwgwgwgwgwgwgwgwgwgwgwgwgwgwgwgwgwgwgwgwg
wgwgwgwgwgwgwgwgwgwgwgwgwgwgwgwgwgwgwgwgwgwgwgwgwgwgwgwgwgwgwgwgwgwgwgwgwgwgwgwgwgwgwgwgwgwgwgwgwgwgwgwgwgwgwgwgwgwgwgwg
wgwgwgwgwgwgwgwgwgwgwgwgwgwgwgwgwgwgwgwgwgwgwgwgwgwgwgwgwgwgwgwgwgwgwgwgwgwgwgwgwgwgwgwgwgwgwgwgwgwgwgwgwgwgwgwgwgwgwgwg
wgwgwgwgwgwgwgwgwgwgwgwgwgwgwgwgwgwgwgwgwgwgwgwgwgwgwgwgwgwgwgwgwgwgwgwgwgwgwgwgwgwgwgwgwgwgwgwgwgwgwgwgwgwgwgwgwgwgwgwg
wgwgwgwgwgwgwgwgwgwgwgwgwgwgwgwgwgwgwgwgwgwgwgwgwgwgwgwgwgwgwgwgwgwgwgwgwgwgwgwgwgwgwgwgwgwgwgwgwgwgwgwgwgwgwgwgwgwgwgwg
xqxqxqxqxqxqxqxqxqxqxqxqxqxqxqxqxqxqxqxqxqxqxqxqxqxqxqxqxqxqxqxqxqxqxqxqxqxqxqxqxqxqxqxqxqxqxqxqxqxqxqxqxqxqxqxqxqxqxqxq
xqxqxqxqxqxqxqxqxqxqxqxqxqxqxqxqxqxqxqxqxqxqxqxqdDdDdDhChChChCdDdDdDxqxqxqxqxqxqxqxqxqxqxqxqxqxqxqxqxqxqxqxqxqxqxqxqxqxq
xqxqxqxqxqxqxqxqxqxqxqxqxqxqxqxqxqxqxqxqxqxqxqxqdDhChChChChChChChCdDxqxqxqxqxqxqxqxqxqxqxqxqxqxqxqxqxqxqxqxqxqxqxqxqxqxq
xqxqxqxqxqxqxqxqxqxqxqxqxqxqxqxqxqxqxqxqxqxqxqxqdDhChChChChChChChCdDxqxqxqxqxqxqxqxqxqxqxqxqxqxqxqxqxqxqxqxqxqxqxqxqxqxq
xqxqxqxqxqxqxqxqxqxqxqxqxqxqxqxqxqxqxqxqxqxqxqxqdDhChChChChChChChCdDxqxqxqxqxqxqxqxqxqxqxqxqxqxqxqxqxqxqxqxqxqxqxqxqxqxq
xqxqxqxqxqxqxqxqxqxqxqxqxqxqxqxqxqxqxqxqxqxqxqxqdDhChChChChChChChCdDxqxqxqxqxqxqxqxqxqxqxqxqxqxqxqxqxqxqxqxqxqxqxqxqxqxq
xqxqxqxqxqxqxqxqxqxqxqxqxqxqxqxqxqxqxqxqxqxqxqxqdDhChChChChChChChCdDxqxqxqxqxqxqxqxqxqxqxqxqxqxqxqxqxqxqxqxqxqxqxqxqxqxq
xqxqxqxqxqxqxqxqxqxqxqxqxqxqxqxqxqxqxqxqxqxqxqxqhChChChChChChChChChCxqxqxqxqxqxqxqxqxqxqxqxqxqxqxqxqxqxqxqxqxqxqxqxqxqxq
xqxqxqxqxqxqxqxqxqxqxqxqxqxqxqxqxqxqxqxqxqxqxqxqhChChChChChChChChChCxqxqxqxqxqxqxqxqxqxqxqxqxqxqxqxqxqxqxqxqxqxqxqxqxqxq
xqxqxqxqxqxqxqxqxqxqxqxqxqxqxqxqxqxqxqxqxqxqxqxqdDhChChChChChChChCdDxqxqxqxqxqxqxqxqxqxqxqxqxqxqxqxqxqxqxqxqxqxqxqxqxqxq
xqxqxqxqxqxqxqxqxqxqxqxqxqxqxqxqxqxqxqxqxqxqxqxqdDhChChChChChChChCdDxqxqxqxqxqxqxqxqxqxqxqxqxqxqxqxqxqxqxqxqxqxqxqxqxqxq
xqxqxqxqxqxqxqxqxqxqxqxqxqxqxqxqxqxqxqxqxqxqxqxqdDdDFNEsdDdDFNEsdDdDxqxqxqxqxqxqxqxqxqxqxqxqxqxqxqxqxqxqxqxqxqxqxqxqxqxq
xqxqxqxqxqxqxqxqxqxqxqxqxqxqxqxqxqxqxqxqxqxqxqxqGUnfhChChChChChCHNhoxqxqxqxqxqxqxqxqxqxqxqxqxqxqxqxqxqxqxqxqxqxqxqxqxqxq
xqxqxqxqxqxqxqxqxqxqxqxqxqxqxqxqxqxqxqxqxqxqxqxqGUnfhChChChChChCHNhoxqxqxqxqxqxqxqxqxqxqxqxqxqxqxqxqxqxqxqxqxqxqxqxqxqxq
xqxqxqxqxqxqxqxqxqxqxqxqxqxqxqxqxqxqxqxqxqxqxqxqGUnfhChChChChChCHNhoxqxqxqxqxqxqxqxqxqxqxqxqxqxqxqxqxqxqxqxqxqxqxqxqxqxq
xqxqxqxqxqxqxqxqxqxqxqxqxqxqxqxqxqxqxqxqxqxqxqxqdDdDdDdDdDdDdDdDdDdDxqxqxqxqxqxqxqxqxqxqxqxqxqxqxqxqxqxqxqxqxqxqxqxqxqxq
xqxqxqxqxqxqxqxqxqxqxqxqxqxqxqxqxqxqxqxqxqxqxqxqxqxqxqxqxqxqxqxqxqxqxqxqxqxqxqxqxqxqxqxqxqxqxqxqxqxqxqxqxqxqxqxqxqxqxqxq
xqxqxqxqxqxqxqxqxqxqxqxqxqxqxqxqxqxqxqxqxqxqxqxqxqxqxqxqxqxqxqxqxqxqxqxqxqxqxqxqxqxqxqxqxqxqxqxqxqxqxqxqxqxqxqxqxqxqxqxq
xqxqxqxqxqxqxqxqxqxqxqxqxqxqxqxqxqxqxqxqxqxqxqxqxqxqxqxqxqxqxqxqxqxqxqxqxqxqxqxqxqxqxqxqxqxqxqxqxqxqxqxqxqxqxqxqxqxqxqxq
xqxqxqxqxqxqxqxqxqxqxqxqxqxqxqxqxqxqxqxqxqxqxqxqxqxqxqxqxqxqxqxqxqxqxqxqxqxqxqxqxqxqxqxqxqxqxqxqxqxqxqxqxqxqxqxqxqxqxqxq
xqxqxqxqxqxqxqxqxqxqxqxqxqxqxqxqxqxqxqxqxqxqxqxqxqxqxqxqxqxqxqxqxqxqxqxqxqxqxqxqxqxqxqxqxqxqxqxqxqxqxqxqxqxqxqxqxqxqxqxq
xqxqxqxqxqxqxqxqxqxqxqxqxqxqxqxqxqxqxqxqxqxqxqxqxqxqxqxqxqxqxqxqxqxqxqxqxqxqxqxqxqxqxqxqxqxqxqxqxqxqxqxqxqxqxqxqxqxqxqxq
"}
